CXXV     words(I) = "airplane"
CXXX     words(II) = "alphabet"
CXXXV    words(III) = "aviator"
CXL      words(IV) = "bidirectional"
CXLV     words(V) = "changeme"
CL       words(VI) = "creosote"
CLV      words(VII) = "cyclone"
CLX      words(VIII) = "december"
CLXV     words(IX) = "dolphin"
CLXX     words(X) = "elephant"
CLXXV    words(XI) = "ersatz"
CLXXX    words(XII) = "falderal"
CLXXXV   words(XIII) = "functional"
CXC      words(XIV) = "future"
CXCV     words(XV) = "guitar"
CC       words(XVI) = "gymnast"
CCV      words(XVII) = "hello"
CCX      words(XVIII) = "imbroglio"
CCXV     words(XIX) = "january"
CCXX     words(XX) = "joshua"
CCXXV    words(XXI) = "kernel"
CCXXX    words(XXII) = "kingfish"
CCXXXV   words(XXIII) = "(\b.bb)(\v.vv)"
CCXL     words(XXIV) = "millennium"
CCXLV    words(XXV) = "monday"
CCL      words(XXVI) = "nemesis"
CCLV     words(XXVII) = "oatmeal"
CCLX     words(XXVIII) = "october"
CCLXV    words(XXIX) = "paladin"
CCLXX    words(XXX) = "pass"
CCLXXV   words(XXXI) = "password"
CCLXXX   words(XXXII) = "penguin"
CCLXXXV  words(XXXIII) = "polynomial"
CCXC     words(XXXIV) = "popcorn"
CCXCV    words(XXXV) = "qwerty"
CCC      words(XXXVI) = "sailor"
CCCV     words(XXXVII) = "swordfish"
CCCX     words(XXXVIII) = "symmetry"
CCCXV    words(XXXIX) = "system"
CCCXX    words(XL) = "tattoo"
CCCXXV   words(XLI) = "thursday"
CCCXXX   words(XLII) = "tinman"
CCCXXXV  words(XLIII) = "topography"
CCCXL    words(XLIV) = "unicorn"
CCCXLV   words(XLV) = "vader"
CCCL     words(XLVI) = "vampire"
CCCLV    words(XLVII) = "viper"
CCCLX    words(XLVIII) = "warez"
CCCLXV   words(XLIX) = "xanadu"
CCCLXX   words(L) = "xyzzy"
CCCLXXV  words(LI) = "zephyr"
CCCLXXX  words(LII) = "zeppelin"
CCCLXXXV words(LIII) = "zxcvbnm"
